1111111111111
10C1000E000C1
1000CCCCCC001
100011E0000P1
1111111111111
