111111
111111
111111
10CPE1
111111
111111
